{
    "rooms": {
        "emptyRoom": [
            "XXXXX",
            "XOOOX",
            "XOOOX",
            "XOOOX",
            "XXXXX"
        ],
        "pillarRoom": [
            "XXXXX",
            "XOOOX",
            "XOXOX",
            "XOOOX",
            "XXXXX"
        ],
        "largeRoom": [
            "XXXXXXXXXX",
            "XOOOOOOOOX",
            "XOOOOOOOOX",
            "XOOOOOOOOX",
            "XOOOOOOOOX",
            "XOOOOOOOOX",
            "XOOOOOOOOX",
            "XXXXXXXXXX"
        ],
        "hugeRoom": [
            "XXXXXXXXXXXXXXXXXXXXXXXXXXXXXXXXXXXXXXXXXXXXXXXXXXXXXXXXX",
            "XOOOOOOXOOOXOOOOOOOOOOXOOOOOOOOOOOOOOOOOOOOOOOOOOOOOOOOOX",
            "XOOOOOOOOOOXOOOOOOOOOOXOOOOOOOOOOOOOOOOOOOOOOOOOOOOOOOOOX",
            "XOOOOOOOOOOXOOOOOOOOOOXOOOOOOOOOOOOOOOOOOOOOOOOOOOOOOOOOX",
            "XOOOOOOXOOOXXXXXXXXOOOXOOOOOOOOOOOOOOOOOOOOOOOOOOOOOOOOOX",
            "XXXXXXXXOOOXOOOOOOOOOOXOOOOOOOOOOOOOOOOOOOOOOOOOOOOOOOOOX",
            "XOOOOOOXOOOXOOOOOOOOOOXOOOOOOOOOOOOOOOOOOOOOOOOOOOOOOOOOX",
            "XOOOOOOXOOOXXXXXXXXOOOXXXXXXXXXXXXXXXXXXXXXXXXXXXXXXXOOOX",
            "XOOOOOOXOOOXOOOOOOOOOOOOOOOOOOOOOOOOOOOOOOOOOOOOOOOOOOOOX",
            "XOOOOOOXOOOXOOOOOOOOOOOOOOOOOOOOOOOOOOOOOOOOOOOOOOOOOOOOX",
            "XOOOOOOXOOOXXXXXXXXXXXXXXXXXXXXXXXXXXXXXXXXXXXXXXXXXXOOOX",
            "XOOOOOOXOOOXOOOOOOOOOOXOOOOOXOOOOOOOOXOOOOOOOXOOOOOOOOOOX",
            "XOOOOOOXOOOXOOOOOOOOOOXOOOOOXOOOOOOOOOOOOOOOOOOOOOOOOOOOX",
            "XOOOOOOXOOOXXXOOOXXXXXXOOOOOXOOOXOOOOOOOOXOOOOOOOXXXXXXXX",
            "XOOOOOOXOOOOOOOOOOOOOOOOOOOOXOOOXXXXXXXXXXXXXXXXXXXXXXXXX",
            "XOOOOOOXOOOOOOOOOOOOOOOOOOOOXOOOOOOOOOOOOOOOOOOOOOOOOOOOX",
            "XOOOOOOXOOOXXXOOOXXXXXXOOOOOXOOOOOOOOOOOOOOOOOOOOOOOOOOOX",
            "XOOOOOOXOOOXOOOOOOOOOOXOOOOOXXXXXXXXXXXXXXXXXXXXXXXXOOOOX",
            "XOOOOOOXOOOXOOOOOOOOOOXOOOOOXOOOOOOOOOOOOOOOOOOOOOOOOOOOX",
            "XOOOOOOXOOOXOOOOOOOOOOXOOOOOXOOOOOOOOOOOOOOOOOOOOOOOOOOOX",
            "XOOOOOOXOOOXOOOOOOOOOOXOOOOOXOOOOXXXXXXXXXXXXXXXXXXXXXXXX",
            "XOOOOOOXOOOXOOOOOOOOOOXOOOOOXOOOOOOOOOOOOOOOOOOOOOOOOOOOX",
            "XOOOOOOXOOOXOOOOOOOOOOXOOOOOXOOOOOOOOOOOOOOOOOOOOOOOOOOOX",
            "XOOOOOOXOOOXOOOOOOOOOOXOOOOOXXXXXXXXXXXXXXXXXXXXXXXXOOOOX",
            "XOOOOOOOOOOXOOOOOOOOOOXOOOOOOOOOOOOOOOOOOOOOOOOOOOOOOOOOX",
            "XOOOOOOOOOOXOOOOOOOOOOXOOOOOOOOOOOOOOOOOOOOOOOOOOOOOOOOOX",
            "XXXXXXXXXXXXXXXXXXXXXXXXXXXXXXXXXXXXXXXXXXXXXXXXXXXXXXXXX"
        ]
    }
}